111111111111111111111111111111111111111111111
100000000000000C0000000000000000000C0000100E1
101C010100C0100000010101010000001000100000101
10000000010000101000000C000000100000C00000001
10P00000000000000000000000000000000C000010001
1010000100000010000000000C00C0000000000000101
10000C0001000000110000100000000100C0000010001
100000000000CC000000C000000000000000CCC000001
111111111111111111111111111111111111111111111